111000000000000
001000000000000
001111111110000
000000000110000
111111100100000
100000100111110
111100100000010
000100111111010
000100000001010
111111111101011
100000000101001
111111000111001
000001000000001
000001111111111
000000000000001
