1110000000
0011110000
0000010000
1111111100
1000000100
1111100111
1000000001
1100111101
0100000101
0111111111
